1050|675|100|100|400|0
1450|675|100|100|400|0
1850|675|100|100|400|0
4350|675|100|100|400|0
4750|675|100|100|0|400
5350|275|100|100|150|50